アーキテクチャ: architecture
アーケード: arcade (street)
アース: earth
アーチ: home run
アーティスト: artist
アーチスト: artist
アート: art
アールデコ: art deco
アイシャドー: eyeshadow
アイス: ice
アイスクリーム: ice cream
アイスホッケー: ice hockey
アイゼン: metal pins of climbing shoes
アイソトープ: isotope
アイテム: item
アイデア: idea
アイディア: idea
アイデンティティ: identity
アイデンティティー: identity
アイドル: performer (usu. in a boy band or girl group) with an image cultivated to foster a dedicated fan following
アイヌ: Ainu
アイメート: seeing-eye dog
アイライン: eyeliner
アイリス: iris
アイロン: iron (for pressing clothes)
アウトバーン: autobahn (highway in Germany, Austria and Switzerland)
アウトレット: electrical outlet
アカデミー: academy
アカデミック: academic
アクアトロン: artificial environment control for aquatic plants and animals
アクシデント: accident
アクション: action
アクセサリー: accessory (fashion)
アクセス: access (to a place, esp. using public transport)
アクセル: accelerator
アクセント: accent (on a syllable, word)
アクリル: acrylic (esp. fibre or resin)
アクロバット: acrobatics
アグレッシブ: aggressive
アコーディオン: accordion
アシスタント: assistant
アシスト: assistance
アジ: agitation
アジア: Asia
アジト: hideout
アスパラガス: asparagus
アスピーテ: aspite
アスピリン: aspirin
アスファルト: asphalt
アスベスト: asbestos
アスレチック: adventure course
アスレチックス: athletics
アセス: assessment
アタック: attack
アダージョ: adagio
アチーブ: achievement test
アット: @ sign
アップ: rise
アップル: apple
アディオス: adios
アトピー: atopic dermatitis
アトラクション: attraction
アトリエ: atelier
アド: address
アドバイザー: adviser
アドバイス: advice
アドバルーン: advertising balloon
アドリブ: ad lib
アドレス: address
アナ: announcer
アナウンサー: announcer
アナウンス: announcement (esp. over public-address system)
アナリスト: analyst
アニメ: animation
アバウト: approximate (number)
アパート: apartment building
アパルトヘイト: apartheid
アビタシオン: habitation
アフターヌーン: afternoon
アフリカーンス: Afrikaans (language)
アブサン: absinthe
アプリ: app
アプリケーション: application
アプローチ: approach (to a problem, issue, etc.)
アベック: (romantic) couple
アマ: amateur
アマチュア: amateur
アマン: lover
アミ: friend
アムール: love
アメフト: American football
アメラグ: American football
アメリカン: American
アラー: Allah
アラカルト: à la carte
アラブ: Arab
アリア: aria
アリバイ: alibi
アルカイズム: archaism
アルカリ: alkali
アルコール: alcohol
アルゴリズム: algorithm
アルデヒド: aldehyde
アルト: alto
アルバイト: part-time job
アルバトロス: albatross (seabird)
アルバム: album
アルファベット: alphabet
アルプス: the Alps
アルミ: aluminum
アルミニウム: aluminum (Al)
アレルギー: allergy
アレンジ: arrangement (of music)
アロハ: aloha
アンカー: anchor (of a ship)
アングラ: underground
アングロサクソン: Anglo-Saxon
アンケート: questionnaire
アンコール: encore
アンサンブル: ensemble
アンダー: underexposure
アンチテーゼ: antithesis
アンティーク: antique
アンテナ: antenna
アントニム: antonym
アンドロイド: android
アンバランス: unbalance
アンファンテリブル: enfant terrible
アンプ: amplifier
アンモニア: ammonia
イージー: easy
イースター: Easter
イースト: yeast
イエス: Jesus (Christ)
イエロー: yellow card
イオン: ion
イクラ: salted salmon roe
イコール: equals sign
イコン: icon (religious)
イスラエル: Israel
イスラム: Islam
イズム: -ism
イデオロギー: ideology
イブ: eve (esp. Christmas Eve)
イベント: event
イメージ: image (in one's mind)
イヤホン: earphones
イヤリング: earring
イラク: Iraq
イラスト: illustration
イルミネーション: illumination
インク: ink
インシュリン: insulin
インスタント: instant
インストラクター: instructor
インセンティブ: incentive
インター: interchange
インターン: intern
インタビュー: interview (i.e. television, newspaper, etc.)
インタラクティブ: interactive
インチ: inch
インテリ: intellectual
インテリア: interior (of building, room, vehicle, etc.)
インテリジェント: intelligent
インテル: Intel (chip manufacturer)
インディアン: (American) Indian
イントネーション: intonation
イントロ: intro
インドネシア: Indonesia
インパクト: impact (on)
インフォメーション: information
インフラ: infrastructure
インフルエンザ: influenza
インフレ: inflation
インプット: input
ウール: wool
ウイークエンド: weekend
ウィジェット: widget
ウイスキー: whisky
ウインカー: (car) turn signal
ウィンカー: (car) turn signal
ウインドウ: window
ウイ: yes
ウイニングボール: winning ball
ウイルス: virus
ウィルス: virus
ウインク: wink
ウインタースポーツ: winter sports
ウインドサーフィン: windsurfing
ウエートレス: waitress
ウェールズ: Wales
ウエア: wear
ウェブ: Web
ウエスタン: Western (film genre)
ウエスト: waist
ウェスト: waist
ウエット: wet
ウォーターカラー: watercolor
ウォン: won (Korean currency)
ウオン: won (Korean currency)
ウクレレ: ukulele
ウッド: wood
ウムラウト: umlaut
ウラン: uranium (U)
エーカー: acre
エース: ace
エアコン: air conditioner
タバコ: tobacco
カレーライス: curry and rice
シャンソン: chanson
ブラシ: brush
チェコスロバキア: Czechoslovakia
ディズニー: Disney
ソフトドリンク: soft drink
チョッキ: waistcoat
ブリキ: tin plate
リストラ: (corporate) restructuring
カチューシャ: Alice band
ワンボックスカー: minivan
プルークボーゲン: snowplow turn
ノスタルジック: nostalgic
ホームページ: home page (of a website or browser)
カイゼル: kaiser
ガーディアン: guardian
ヴァンパイア: vampire
ダンピング: dumping
リビア: Libya
エアゾール: aerosol
エアロビクス: aerobics
ＡＩＤＳ: acquired immune deficiency syndrome
エイリアン: alien
エキサイティング: exciting
エキストラ: extra (e.g. in a film)
エキスパート: expert
エキスポ: expo
エキセントリック: eccentric
エクアドル: Ecuador
エクスプレス: express
エキスプレス: express
エコー: ultrasound scan
エコールドパリ: École de Paris
エコノミー: economy (class)
エコノミックアニマル: economic animal
エコロジー: ecology
エコロジ: ecology
エゴ: ego
エジプト: Egypt
エスカレーター: escalator
エスカレート: escalation
エスキモー: Eskimo
エステティック: beauty treatment
エステティックサロン: beauty salon
エスニック: ethnic
エスプリ: spirit
エスペラント: Esperanto
エチケット: politeness
エッセイ: essay
エッセー: essay
エディター: text editor
エナジー: energy
エネルギー: energy
エネルギッシュ: energetic
エバー: ever
エピソード: episode
エプロン: apron
エペ: épée (fencing)
エホバ: Jehovah
エラー: error
エリート: elite
エリア: area
エルニーニョ: El Niño
エレキ: electricity
エレキギター: electric guitar
エレクトロニクス: electronics
エレベーター: elevator
エロ: erotic
エロス: eros
エンジニア: engineer
エンジニアリング: engineering
エンジョイ: enjoying
エンジン: engine
エンターテイナー: entertainer
エンディング: ending
エントリー: entry (in an event, competition, etc.)
オーク: oak
オークション: auction
オーケストラ: orchestra
オーダー: order
オーダーメード: made-to-order
オーディション: audition
オート: auto
オートキャンプ: motor home camping
オートクチュール: haute couture
オートバイ: motorcycle
オートマチック: automatic transmission
オートメーション: automation
オートロック: automatic lock
オードブル: hors d'oeuvre
オーナー: owner (esp. of a business)
オーバー: overcoat
オーバ: overcoat
オーブン: oven
オープニング: opening credits
オープン: opening (a new store, golf course, runway, etc.)
オープンカー: open-top car
オーボエ: oboe
オーラ: aura
オーロラ: aurora
オアシス: oasis
オイル: oil
オカリナ: ocarina (type of flute)
オクターブ: octave
オケ: orchestra
オスカー: Oscar
オゾン: ozone
オゾンホール: ozone hole
オタク: otaku
オタワ: Ottawa
オックスフォード: ∅
オニオン: onion (Allium cepa)
オハイオ: Ohio
オフィス: office
オフレコ: off-the-record
オブジェ: objet d'art
オブラート: paper-thin wafer (for wrapping powdered medicine, candies, etc.)
オプション: option
オペ: operation
オペラ: opera
オペレーター: operator
オペレッタ: operetta
オムレツ: omelette
オラトリオ: oratorio
オリエンタル: oriental
オリエンテーション: orientation
オリエント: Orient
オリジナリティー: originality
オリジナル: original
オリンピック: Olympics
オルガン: organ (musical instrument)
オルグ: organizer
オルゴール: music box
オレンジ: orange (fruit, colour)
オンス: ounce
オンパレード: display
オンブズマン: ombudsman
オンライン: online
オンリー: only
カー: car
カーテン: curtain
カート: (shopping) cart
カートリッジ: cartridge
カード: card (information, filing, etc.)
カーニバル: carnival
カーネーション: carnation (Dianthus caryophyllus)
カーブ: curve
カーペット: carpet
カール: curl
カーレース: car race
カウチポテト: couch potato
カウボーイ: cowboy
カウンセリング: counseling
カウンター: counter
カウント: count
カオス: chaos
カクテル: cocktail
カジノ: casino
カステラ: castella (type of sponge cake)
カスバ: kasbah
カセット: cassette (tape)
カタル: catarrh
カタログ: catalog
カッター: box cutter
カット: haircut
カップ: cup (drinking vessel, measure, brassiere, prize, etc.)
カップル: couple
カツ: cutlet (usu. crumbed and fried)
カテーテル: catheter
カテゴリー: category
カテドラル: cathedral
カデンツ: cadence
カトリック: Catholic
カトレヤ: cattleya (type of orchid)
カヌー: canoe
カバー: cover
カフェ: café
カフェイン: caffeine
カフェテリア: cafeteria
カプセル: capsule
カプリッチオ: capriccio
カメラ: camera
カメラマン: photographer
カメレオン: chameleon
カラー: color
カラフル: colorful
カリウム: potassium (K)
カリキュラム: curriculum
カリスマ: charisma (i.e. attractiveness, charm)
カリフォルニア: California
カルキ: chlorinated lime
カルシウム: calcium (Ca)
カルチャーショック: culture shock
カルチャーセンター: cultural center
カルテ: patient's chart
カルテット: quartet
カルテル: cartel
カルバドス: calvados
カルメラ: honeycomb toffee
カレッジ: college
カレンシー: currency
カレンダー: calendar
カロリー: calorie
カンカン: can-can
カンガルー: kangaroo
カンザス: Kansas
カンタータ: cantata
カンツォーネ: canzone
カンニング: cheating (on an examination)
カンパ: (political) campaign
カンフル: camphor
ガーゼ: gauze
ガーデン: garden
ガードマン: security guard
ガードレール: guardrail
ガイド: guide
ガイドブック: guidebook
ガウン: gown
ガス: gas (as a fuel)
ガストアルバイター: foreign worker
ガスボンベ: gas cylinder
ガソリン: gasoline
ガソリンスタンド: gas station
ガッツ: guts
ガッツポーズ: triumphant pose (assumed by an athlete, etc.)
ガット: gut (used to make tennis rackets, violin strings, etc.)
ガボット: gavotte
ガム: chewing gum
ガメラン: gamelan (traditional Indonesian music ensemble)
ガラス: glass
ガリバー: Gulliver
ガリレオ: Galileo
ガレージ: garage
ガロン: gallon
キー: key (lock, keyboard, piano, clue, island, cay, etc.)
キーステーション: key station
キーパー: goalkeeper
キープ: to keep (e.g. the lead)
キーホルダー: keychain
キーボード: keyboard
キーワード: keyword
キッチン: kitchen
キット: kit
キムチ: kimchi
キャスター: newscaster
キャッチ: catch
キャッチャー: catcher
キャッツアイ: cat's-eye (semiprecious stone)
キャットウォーク: catwalk (at a fashion show)
キャップ: cap (headwear)
キャディー: caddie
キャバレー: cabaret
キャビア: caviar
キャビネット: cabinet
キャブレター: carburetor
キャプテン: captain
キャベツ: cabbage (Brassica oleracea)
キャリア: career
キャロル: carol
キャンセル: cancellation
キャンドル: candle
キャンバス: canvas
カンバス: canvas
キャンパー: camper
キャンパス: campus
キャンピングカー: mobile home
キャンプ: camp
キャンプイン: beginning training camp
キャンペーン: promotion (e.g. sales, etc.)
キュート: cute
キューバ: Cuba
キュロット: culotte
キリスト: Christ
キルビメーター: curvimeter
キロ: kilo-
キログラム: kilogram
キロメートル: kilometer
ギア: gear
ギガ: gigabyte
ギター: guitar
ギタリスト: guitarist
ギブアップ: give up
ギプス: plaster cast
ギャラ: fee paid to performing artists, etc.
ギャラリー: gallery
ギャル: gyaru
ギャルソン: (male) waiter
ギャング: gang
ギャンブラー: gambler
ギャンブル: gambling
ギロチン: guillotine
クーキー: cookie
クーデター: coup d'état
クーペ: coupé
クーポン: coupon
クーラー: air conditioner
クール: cool (temperature, color, etc.)
クイズ: quiz
クインテット: quintet
クウェート: Kuwait
クエーサー: quasar
クオート: quart
クオリティ: quality
クッキー: cookie
クック: cook
クッション: cushion
クライアント: client
クライマックス: climax
クラウン: crown
クラクション: (car) horn
クラシック: classical music
クラス: class
クラスメート: classmate
クラッチ: clutch
クランクイン: start (of) filming
クリーク: 5-wood (club)
クリーニング: cleaning
クリーム: cream
クリーンアップトリオ: third, fourth, and fifth batters
クリオール: creole
クリケット: cricket (game)
クリスチャン: Christian
クリスマス: Christmas
クリスマスイヴ: Christmas Eve
クリスマスカード: Christmas card
クリスマスツリー: Christmas tree
クリック: click
クリップ: clip (paper, surgical, etc.)
クリニック: clinic
クルー: crew
クルス: cross sign
クルド: Kurd
クレージー: crazy
クレーター: pockmark
クレープ: crêpe
クレーム: (general) complaint
クレーン: crane (machine)
クレジット: credit
クレジットカード: credit card
クレムリン: Russian government
クレンザー: cleanser
クローク: cloakroom
クローズアップ: close-up
クロール: crawl (swimming)
クローン: clone
クロアチア: Croatia
クロス: cross
クロム: chromium (Cr)
クロレラ: chlorella (alga)
グー: good
グアム: Guam
グッズ: goods
グライダー: glider
グラウンド: field
グラス: glass (drinking vessel)
グラスファイバー: glass fiber
グラタン: gratin
グラチェ: thank you
グラデーション: gradation haircut
グラフ: graph
グラマー: voluptuous woman
グラム: gram
グランス: glans
グランデ: grand
グランドピアノ: grand piano
グランプリ: Grand Prix
グリークラブ: glee club
グリーン: green (colour)
グリーンピース: green peas
グリンピース: green peas
グリーンランド: Greenland
グルー: glue
グループ: group (usu. of people)
グルメ: fine food
グレー: grey
グレイ: grey
グレープフルーツ: grapefruit
グロ: grotesque
グローブ: glove (esp. in sports)
グロテスク: grotesque
グロリア: Gloria
ケーキ: cake
ケース: case (e.g. receptacle, condition, event, legal action, letter style, etc.)
ケイス: case (e.g. receptacle, condition, event, legal action, letter style, etc.)
ケーブル: cable
ケア: care
ケチャップ: ketchup
ケベック: Quebec
ケロイド: keloid
ゲート: gate (for entry, boarding, etc.)
ゲーム: game
ゲームセット: game, set and match
ゲームセンター: game arcade
ゲイ: gay person (esp. male)
ゲシュタポ: Gestapo
ゲスト: guest
ゲットー: ghetto
ゲノム: genome
ゲバリスタ: Guevarista
ゲリラ: guerrilla
ゲル: gel
ゲルマン: Germanic (people, language, culture, etc.)
ゲレンデ: ski slope
ゲン: gene
コークスクリュー: corkscrew
コース: course
コースター: roller coaster
コーチ: coach
コート: coat
コード: code
コーナー: corner
珈琲: coffee
コーポ: apartment building
コーラ: cola (carbonated soft drink)
コーラス: chorus
コーラン: Koran
コール: (telephone) call
コールド: cold
コールドゲーム: called game
コアビタシオン: cohabitation
コアラ: koala
コイル: coil
コイン: coin
コインロッカー: coin-operated locker
コカイン: cocaine
コギトエルゴスム: cogito, ergo sum
ココア: cocoa (beverage, cocoa solids)
コスト: cost
コック: cook
コップ: glass (drinking vessel)
コテージ: cottage
コニーデ: stratovolcano
コニャック: cognac
コネ: connection
コバルト: cobalt blue
コピー: copy
コペルニクス: Copernicus (1473-1543)
コマーシャル: commercial (e.g. TV)
コマンド: command
コミック: comic books
コミュニケ: communiqué
コミュニケーション: communication
コミュニティ: community
コミュニティー: community
コミンテルン: Comintern
コメディー: comedy
コメディアン: comedian
コメント: comment
コラージュ: collage
コラール: choral
コラム: column (e.g. in newspaper)
コラムニスト: columnist
コリー: collie
コリア: Korea
コル: col
コルク: cork
コレクション: collection (of art, stamps, etc.)
コレクター: collector
コレステロール: cholesterol
コロシアム: Colosseum
コロッケ: croquette
コロニー: colony
コロラド: Colorado
コロン: eau de Cologne
コンクール: competition
コンクリート: concrete
コンコルド: Concorde
コンサート: concert
コンサルタント: consultant
コンセプト: concept
コンセンサス: consensus
コンセント: electrical outlet
コンタクト: contact
コンタクトレンズ: contact lens
コンチェルト: concerto
コンテ: storyboard
コンテスト: contest
コンディション: condition
コント: conte
コントラスト: contrast
コントラバス: contrabass
コントロール: control
コンドーム: condom
コンドミニアム: condominium
コンドル: condor (incl. other New World vultures of family Cathartidae)
コンバイン: combine
コンパ: party
コンパクト: compact
コンパス: pair of compasses
コンパニオン: promotional model (at a trade show, etc.)
コンビ: combination
コンビナート: industrial complex
コンビニ: convenience store
コンピュータ: computer
コンピューター: computer
コンブリオ: con brio
コンマ: comma
ゴーグル: goggles
ゴースト: ghost
ゴーストタウン: ghost town
ゴール: goal
ゴールイン: reaching the winning post
ゴールデンアワー: prime time television
ゴールデンウィーク: Golden Week
ゴールデンタイム: prime time (on television or radio)
ゴキブリ: cockroach
ゴシック: Gothic (style)
ゴスペル: the Gospels
ゴム: gum
ゴリラ: gorilla (Gorilla spp., esp. western gorilla, Gorilla gorilla)
ゴルジュ: gorge
ゴルフ: golf
ゴルファー: golfer
ゴロ: grounder
ゴング: gong (instrument)
ゴンドラ: gondola (boat, esp. in Venice)
サーカス: circus
サーバ: server
サーバー: server
サービス: service
サービスエース: ace (serve; in tennis, volleyball, etc.)
サーファー: surfer
サーフィン: surfing
サーブ: serve
サーモン: salmon
サイクリング: cycling
サイクル: cycle
サイズ: size
サイト: site (usu. website)
サイド: side
サイレン: siren
サイレント: silent movie
サイン: autograph
サウジ: Saudi Arabia
サウジアラビア: Saudi Arabia
サウナ: sauna
サウンド: sound
サザンクロス: Southern Cross (asterism formed with the brightest four stars of the constellation Crux)
サスペンション: suspension (mixture)
サスペンス: suspense (esp. in a film, novel, etc.)
サターン: Saturn (Roman god)
サッカー: soccer
サックス: saxophone
サテン: satin
サド: sadist
サハラ: Sahara
サバンナ: savanna
サファリ: safari
サブマリン: submarine
サポート: support
サマースクール: summer school
サミット: summit
サラダ: salad
サラリー: salary
サラリーマン: office worker
サルサ: salsa (dance)
サロン: salon
サンクスギビングデー: Thanksgiving Day
サンクチュアリ: Sanctuary (faction of the Constitutional Democratic Party of Japan)
サングラス: sunglasses
サンタクロース: Santa Claus
サンダル: sandal
サンチュール: belt
サンディエゴ: San Diego
サントラ: soundtrack
サンドイッチ: sandwich
サンバ: samba
サンフランシスコ: San Francisco
サンプル: sample
サンボ: self-defence (defense) (type of wrestling)
ザンビア: Zambia
シークレットサービス: secret service
シーズン: season (period in which regulated games are played)
シーズンオフ: off-season
シーソーゲーム: seesaw game
シーツ: sheet
シート: seat
シーフード: seafood
シームレス: seamless stockings
シアター: theater
シアトル: Seattle
シアン: cyan
シェイク: milkshake
シェーク: milkshake
シェーバー: shaver
シェア: sharing
シェイプアップ: getting in shape
シェパード: German shepherd
シェフ: chef
シェルター: shelter
シエスタ: siesta
シカゴ: Chicago
シクラメン: cyclamen (esp. species Cyclamen persicum)
シスター: sister (sibling)
システム: system
シチュー: stew
シック: chic
シックスナイン: sixty-nine (sexual position)
シドニー: Sydney
シナモン: cinnamon
シナリオ: script
シナリオライター: scriptwriter
シネマ: cinema
シノニム: synonym
シフォン: chiffon
シフト: shift
シベリア: Siberia
シミーズ: chemise
シミュレーション: simulation
シャープ: sharp
シャープペンシル: propelling pencil
シャッター: (camera) shutter
シャットアウト: shutout
シャッポ: hat
シャツ: shirt (undergarment)
シャトー: château
シャトル: shuttlecock
シャトルバス: shuttle bus
シャフト: shaft (e.g. machinery)
シャベル: shovel
ショベル: shovel
シャルマン: charming
シャワー: shower
シャン: beautiful
シャンデリア: chandelier
シャンパン: champagne
シャンプー: shampoo
シュークリーム: cream puff
シューズ: shoes
シュート: shooting (a ball)
シュール: surrealism
シュールレアリズム: surrealism
シュガー: sugar
シュテムボーゲン: stem turn in skiing
シュトゥルムウントドラング: Sturm und Drang
シュナップス: liquor
シュプレヒコール: choral chanting
ショー: show
ショウ: show
ショーウィンドウ: display window
ショーケース: showcase
ショート: short
ショートカット: shortcut
ショートパンツ: shorts
ショールーム: showroom
ショッキング: shocking
ショック: shock (psychological)
ショット: shot
ショッピング: shopping
ショッピングモール: shopping mall
ショップ: shop
ショパン: Chopin
ショルダーバッグ: shoulder bag
シリーズ: series
シリアス: serious
シリウス: Sirius (star in the constellation Canis Major)
シリコン: silicon (Si)
シルエット: silhouette
シルク: silk
シルクロード: Silk Road
シロップ: syrup
シン: thin
シンガー: singer
シンガポール: Singapore
シンク: sink
シンクロ: synchronization
シングル: single
シングルス: singles (tennis, badminton, etc.)
シンドローム: syndrome
シンナー: (paint) thinner
シンパ: (Communist, union, etc.) sympathizer
シンフォニー: symphony
シンプル: simple
シンボル: symbol
シンポ: symposium
ジープ: jeep
ジーン: jeans
ジーンズ: jeans
ジェスチャー: gesture
ジェット: jet
ジェットコースター: roller coaster
ジェラシー: jealousy
ジグザグ: zig-zag
ジハード: jihad
ジパング: Zipangu (the name for Japan used by Marco Polo)
ジブ: jib
ジプシー: gypsy
ジム: gym
ジャー: vacuum bottle
ジャーナリスト: journalist
ジャーナリズム: journalism
ジャカルタ: Jakarta (Indonesia)
ジャガー: jaguar (Panthera onca)
ジャケット: jacket
ジャスト: just
ジャズ: jazz
ジャック: hijack
ジャパン: Japan
ジャポニカ: japonica
ジャマイカ: Jamaica
ジャム: jam
ジャンクション: junction
ジャングル: jungle
ジャンプ: jump
ジャンボ: jumbo jet
ジャンル: genre
ジュース: juice
ジューンブライド: June bride
ジュネーブ: Geneva
ジュピター: Jupiter (Roman god)
ジュリー: jury
ジョーカー: joker
ジョーク: joke
ジョギング: jogging
ジョッキ: beer mug
ジン: gin
メールアドレス: email address
ブログ: blog
チーズケーキ: cheese cake
ノー: no
バファリン: Bufferin (brand of buffered aspirin)
コレラ: cholera
ナビ: navigation
ジンバブエ: Zimbabwe
スーツ: suit (clothing)
スーツケース: suitcase
スーパー: supermarket
スーパーボウル: Super Bowl
スーパーマン: superman
スープ: (Western) soup
スイート: sweet (of alcohol)
スイッチ: switch
スイマー: swimmer
スイング: swing (of a golf club, tennis racket, etc.)
スカート: skirt
スカーフ: scarf (esp. a lightweight summer scarf worn by women)
スカウト: Boy Scouts
スカッシュ: squash (drink)
スカンク: skunk (i.e. preventing someone from scoring entirely)
スキー: skiing
スキーヤー: skier
スキッパー: skipper
スキャンダル: scandal
スキューバ: scuba
スキン: skin (custom graphical user interface for an application)
スキンシップ: physical contact (between friends, mother and child, etc.)
スクール: school
スクエア: square (tool)
スクラップ: scrap
スクラム: scrum (rugby)
スクリーン: screen
スクリプター: script supervisor
スクリュー: screw
スケーター: skater
スケート: skating (esp. ice)
スケートリンク: ice skating rink
スケープゴート: scapegoat
スケジュール: schedule
スケッチ: sketch
スケッチブック: sketchbook
スコープ: scope (i.e. an optical device)
スコール: skoal
スコア: score
スコッチ: Scotch
スコップ: shovel
スター: star (cinema, sports, etc.)
スターズアンドストライプス: Stars and Stripes (US flag)
スタート: start
スタートライン: starting line
スタイミー: situation in which there is an obstacle (e.g. a tree) between the ball and the green
スタイル: (one's) figure
スタジアム: stadium
スタジオ: studio
スタッフ: staff
スタメン: starting lineup
スタンド: stand (e.g. newspaper stand)
スチーム: steam
スチール: steel
スチュワーデス: stewardess
ステーキ: steak
ステーション: station
ステージ: stage
ステートアマ: state amateur (government-funded sportsperson in training)
ステッカー: sticker
ステッキ: (walking) stick
ステップ: step (movement)
ステレオ: stereo (sound)
ステンレス: stainless steel
スト: strike (i.e. industrial action)
ストーブ: (room) heater
ストーリー: story
ストア: store
ストッキング: stockings
ストック: stock
ストップ: stop
ストップウォッチ: stopwatch
ストライキ: strike (i.e. industrial action)
ストライク: strike (e.g. in baseball, bowling)
ストリート: street
ストリップ: strip show
ストレート: straightforward
ストレス: stress
ストロー: drinking straw
ストロベリー: strawberry
ストロボ: stroboscope
ストロンチウム: strontium (Sr)
スナック: snack
スナップ: snapshot
スノー: snow
スノーボート: (plastic) toboggan
スパート: spurt
スパイ: spy
スパイク: spike (on a shoe or tyre)
スパイス: spice
スパゲティ: spaghetti
スパッツ: leggings (stretchy skin-tight trousers)
スパン: span
スピーカー: speaker
スピーチ: speech
スピード: speed
スピードアップ: speeding up
スピン: ribbon bookmark (attached to the binding)
スフィンクス: sphinx
スプーン: spoon
スプリンクラー: sprinkler
スプレー: spray
スペース: space (room, area, outer space)
スペースシャトル: space shuttle
スペア: spare (bowling)
スペクトル: spectrum (radio, etc.)
スペシャル: special
スペル: spelling
スポークスマン: spokesman
スポーツ: sport
スポーツカー: sports car
スポーツマン: sportsman
スポット: place
スポンサー: sponsor
スポンジ: sponge
スマート: slim
スムーズ: smooth
スモッグ: smog
スライス: slice
スライド: (microscope) slide
スラックス: slacks
スラローム: slalom
スランプ: slump
スリーサイズ: bust-waist-hip measurements
スリッパ: slipper
スリップ: slip
スリム: slim
スリラー: thriller (movie, story)
スリリング: thrilling
スリル: thrill
スルー: ignoring
スレート: slate
スレイブ: slave (device)
スロー: slow motion
スローガン: slogan
スロープ: slope
スロット: slot
スワン: swan
ズボン: trousers
セーター: sweater
セーフ: safe
セーフティードライブ: driving safely
セーブ: save
セール: sale
セールス: sales
セールスマン: salesman
セキュリティ: security
セキュリティー: security
セクシー: sexy
セクション: section
セクター: sector
セクハラ: sexual harassment
セゾン: season
セックス: sex
セッション: session
セッティング: setting
セット: set (of things)
セミナー: seminar
ゼミナール: seminar
セメント: cement
セル: serge
セルフ: self-service
セルフサービス: self-service
セレナーデ: serenade
セレナード: serenade
セロハンテープ: cellophane tape
センス: taste (in fashion, music, etc.)
センセーション: sensation
センター: centre
センチ: centimeter
センチメンタル: sentimental
セント: cent (monetary unit)
ゼネコン: general contractor
ゼネスト: general strike
ゼミ: seminar
ゼリー: jello
ソース: sauce
ソーセージ: sausage
ソープ: soapland
ソープランド: soapland
ソックス: socks
ソナタ: sonata
ソビエト: soviet
ソファ: sofa
ソフト: soft
ソフトウェア: software
ソフトウエア: software
ソプラノ: soprano
ソリスト: soloist
ソル: solar day (esp. on planets other than Earth)
ソロ: solo
ソング: song
ターミナル: terminal
タール: tar
タイアップ: tie-in
タイト: tight
タイトル: title
タイピスト: typist
タイプ: type
タイプライター: typewriter
タイマー: timer
タイミング: timing
タイム: time
タイムスタンプ: time-stamping machine
タイムズ: times
タイムマシン: time machine
タイムリー: clutch hit
タイヤ: tire
タイル: tile
タオル: towel
タキシード: tuxedo
タクシー: taxi
タグ: tag
タッチ: touch
タップ: tap dance
タフ: tough
タブー: taboo
タレント: (TV or radio) entertainer
タワー: tower
タンカー: tanker
タンク: tank (of fluid)
タンクローリ: tanker
ダーリン: darling
ダイエット: diet
ダイジェスト: digest
ダイナマイト: dynamite
ダイビング: diving
ダイヤ: diamond
ダイヤモンド: diamond
ダイヤル: dial (e.g. telephone, radio, clock, gauge)
ダイレクト: direct
ダウン: fall
ダウンタウン: downtown
ダッチワイフ: life-sized doll used for masturbation
ダビング: dubbing
ダブル: double
ダム: dam
ダメージ: damage
ダライラマ: ∅
ダンサー: dancer
ダンス: dance
ダンプ: dump truck
ダンプカー: dump truck
チーズ: cheese
チーム: team
チームワーク: teamwork
チア: cheer
チアガール: cheerleader
チェ: tsk
チェーン: chain (bicycle, measuring, tire, etc.)
チェイン: chain (bicycle, measuring, tire, etc.)
チェス: chess
チェッカー: checkers (board game)
チェック: check
チェックアウト: checking out (of a hotel)
チェックイン: check-in
チェロ: cello
チェンジ: switching ends (in tennis, volleyball, etc.)
チェンバロ: harpsichord
チキン: chicken
チケット: ticket
チタン: titanium (Ti)
チップ: tip
チフス: typhoid fever
チベット: Tibet
チャーター: charter
チャーミング: charming
チャイナ: China
チャイム: chime
チャック: zip fastener
チャネル: channel
チャンネル: channel
チャリティ: charity
チャレンジ: taking on (a challenge)
チャンス: chance
チャンピオン: champion
チューブ: tube
チューリップ: tulip
チュニジア: ∅
チョコ: chocolate
チョコレート: chocolate
チリ: Chile
ツーピース: (women's) two piece suit
ツール: tool (esp. software, etc.)
ツアー: tour
ツイン: twin
ツリー: tree (structure, diagram, etc.)
テーゼ: thesis
テーピング: taping (e.g. an injured joint)
テーブル: table
テープ: tape
テープレコーダー: tape recorder
テーマ: theme
テーマパーク: theme park
テーラー: tailor
ティーンエージャー: teenager
ティッシュ: tissue
ティンパニ: timpani
テキ: beefsteak
テキサス: Texas
テキスト: text
テク: technology
テクニカル: technical
テクニック: technique
テクノロジー: technology
テスト: examination
テックス: soft fiberboard
テニス: tennis
テニスコート: tennis court
テネシー: Tennessee
テノール: tenor
テラス: terrace
テリーヌ: terrine
テレクラ: telephone dating or sex service
テレコム: telecommunication
テレックス: telex
テレビ: television
テロ: terror
テロップ: telop
テロリスト: terrorist
テロリズム: terrorism
テント: tent
テンペラ: tempera
テンポ: tempo
データ: data
データベース: database
デート: date (with someone)
ディーゼル: diesel
ディーラー: (car) dealer
ディスカウント: discount
ディスク: disk (storage)
ディスコ: disco
ディスプレイ: display
ディスプレー: display
ディナー: dinner
ディフェンス: defense
ディベート: debate
ディミヌエンド: diminuendo
デイリーニュース: daily news
デオキシルボ: deoxyribo (nucleic acid)
デカルコマニー: transfer
デザート: dessert
デザイナー: designer
デザイン: design
デシ: deci-
デジタル: digital
ディジタル: digital
デスク: desk
デタント: detente
デッキ: deck (e.g. ship, tape, cassette, observation, train vestibule)
デッサン: rough sketch
デッド: dead (sound, room)
デッドヒート: fiercely fought contest
デパート: department store
デビュー: debut
デフォルメ: distortion (often used for caricature in manga, etc.)
デフレ: deflation
デマ: false rumor (rumour)
デメリット: disadvantage
デモ: demonstration
デモンストレーション: demonstration
デュオ: duo
デリカ: delicatessen
デリケート: delicate (issue, problem, etc.)
デンバー: Denver
トーク: talk show
トースター: toaster
トースト: toast
トータル: total
トーナメント: tournament
トイレ: toilet
トス: (coin) toss
トタン: corrugated iron
トップ: top
トップバッター: leadoff batter
トトカルチョ: football pool
トピック: topic
トマト: tomato (Solanum lycopersicum)
トライ: try
トライアングル: triangle (shape)
トラクター: tractor
トラック: truck
トラッド: traditional jazz
トラバーユ: job change
トラブル: trouble
トラベラーズチェック: traveller's cheque
トランク: suitcase
トランジスタ: electrical transistor
トランス: transformer
トランプ: (Western) playing cards
トランペット: trumpet
トリオ: trio
トリック: trick
トリップ: tripcode
トリュフ: truffle
トルコ: Turkey
トレー: tray
トレード: trade
トレードマーク: trademark
トレーナー: trainer (someone who works with sports athletes)
トレーニング: training (for a skill, job, sport, etc.)
トレーラー: trailer (vehicle)
トレンド: trend
トロイ: troy
トロイカ: troika
トロフィー: trophy
トロント: Toronto
トンネル: tunnel
ドーク: moderates (politics)
ドーナツ: doughnut
ドーム: dome
ドア: door (Western-style, car, etc.)
ドキュメンタリー: documentary
ドキュメント: documentation
ドクター: doctor
ドック: dock
ドミノ: domino effect
ドライ: dry
ドライバー: driver (of a vehicle)
ドライフラワー: dried flowers
ドライブ: drive
ドライヤー: dryer (esp. hair)
ドラゴン: dragon (as depicted in Western myths)
ドラフト: draft (esp. in baseball)
ドラマ: (non-documentary) television series
ドラム: drum
ドリアン: durian (fruit)
ドリンク: drink
ドル: dollar
ドレス: dress
ドレッシング: dressing
ドロップ: drop
ナイーブ: innocent
ナイジェリア: Nigeria
ナイター: game under lights (e.g. baseball)
ナイト: knight
ナイトクラブ: nightclub
ナイフ: knife
ナイロン: nylon
ナウ: trendy
ナショナリズム: nationalism
ナショナルリーグ: National League
ナチ: Nazi
ナチズム: Nazism
ナチュラル: natural (sign)
ナックル: knuckleball
ナット: nut (as in nut and bolt)
ナップザック: knapsack
ナトリウム: sodium (Na)
ナプキン: (table) napkin
ナポレオン: Napoleon
ナンセンス: nonsense
ナンバー: number plate
ナンバーワン: number one
ニーズ: needs
ニス: varnish
ニックネーム: nickname
ニッケル: nickel (Ni)
ニヒル: nihilistic
ニュー: new
ニュース: news
ニュートン: Newton (Sir Isaac)
ニューヨーク: New York
ニュアンス: nuance
ヌード: nude
ヌーベル: mid-length novel
ヌーボー: modern
ネーム: nameplate
ネガ: negative
ネガティブ: negative (e.g. thinking)
ネクタイ: tie
ネック: neck
ネックレス: necklace
ネット: Internet
ネットワーク: network
ノータッチ: without touching
ノート: notebook
ノーマーク: not covered (e.g. of a sports opponent)
ノイズ: noise
ノイローゼ: neurosis
ノウハウ: know-how
ノエル: Christmas
ノスタルジー: nostalgia
ノック: knock
ノブ: knob
ノミネート: nomination
ノルディック: Nordic
ノンストップ: nonstop
ノンフィクション: nonfiction
ハーキュリーズ: Hercules
ハート: heart
ハード: hard
ハードディスク: hard-disk
ハードボイルド: hard-boiled (person, style, etc.)
ハードル: hurdle race
ハードロック: hard rock
ハーフタイム: half time
ハーブ: herb
ハープ: harp
ハーモニー: harmony
ハーモニカ: harmonica
ハーラーダービー: race to be the pitcher with the most wins in the season
ハーレム: harem
ハイ: high (spirits)
ハイウェイ: highway
ハイカー: hiker
ハイキング: hiking
ハイジャック: hijack
ハイティーン: late teens
ハイテク: high-tech
ハイヒール: high heels
ハイビジョン: high-definition television
ハイファイ: hi-fi
ハイブリッド: hybrid
ハイペース: quick pace
ハイム: home
ハウス: house
ハッカー: hacker
ハッピーエンド: happy ending
ハネムーン: honeymoon
ハム: ham (cured pig meat)
ハムスター: hamster
ハラハラ: to feel anxious
ハリケーン: hurricane
ハロウィーン: Halloween
ハワイ: Hawaii
ハンカチ: handkerchief
ハンガー: (aircraft) hangar
ハングリー: hungry (e.g. for success)
ハングル: hangul (Korean script)
ハンサム: handsome
ハンスト: hunger strike
ハンター: hunter
ハンチング: hunting cap
ハンディキャップ: handicap
ハンド: handball (soccer foul)
ハンドバッグ: handbag
ハンドボール: handball
ハンドル: handle
ハンバーガー: hamburger (on a bun)
ハンバーグ: Hamburg steak
ハンマー: hammer
バー: bar
バーゲン: bargain
バーゲンセール: bargain sale
バーコード: comb over (on a balding man)
バージニア: Virginia
バージョン: version
バースデー: birthday
バーチャル: virtual
バーテン: bartender
バードウォッチング: birdwatching
バーベキュー: barbecue
バーベル: barbell
バーボン: bourbon
バーミンガム: Birmingham
バレル: barrel
バーレル: barrel
バイオ: biotechnology
バイオテクノロジー: biotechnology
バイオリニスト: violinist
バイオリン: violin
ヴァイオリン: violin
バイキング: Viking
バイク: motorcycle
バイト: part-time job
バイブル: Bible
バイヤー: buyer
バウムクーヘン: baumkuchen (German spit cake)
バウンド: bounce
バカンス: holidays
バギー: dune buggy
バクテリア: bacteria
バグダッド: Baghdad (Iraq)
バザー: bazaar
バザール: bazaar
バス: bus
バスケット: basket
バスケットボール: basketball
バスター: fake bunt
バスト: bust (sculpture)
バスルーム: bathroom
バター: butter
バタバタ: flapping
バッカス: Bacchus (Roman god)
バック: background
バックス: backs
バックスクリーン: batter's eye screen
バックネット: backstop
バックハンド: backhand
バッグ: bag
バッジ: badge
バッティング: batting (baseball, cricket, etc.)
バッテリー: battery
バット: bat (in baseball, cricket, etc.)
バッハ: Bach (German composer, 1685-1750)
バトン: baton (relay, orchestral conducting, etc.)
バトンタッチ: passing the baton (in a relay race)
バドミントン: badminton
バナナ: banana
バニラ: vanilla
バブル: bubble
バラード: ballade (narrative poetry, musical composition)
バラエティ: variety show
バランス: balance
バリア: imaginary shield that gives one invincibility or immunity
バリウム: barium (Ba)
バリエーション: variation
バリカン: barber's clippers
バリケード: barricade
バルコニー: balcony
バレー: volleyball
バレーボール: volleyball
バレエ: ballet
バレリーナ: ballerina
バレンタイン: (Saint) Valentine
バレンタインデー: Valentine's Day
バロック: baroque
バロメーター: barometer (instrument)
バンクーバー: Vancouver
バンコク: ∅
バント: bunt
バンド: band
バンパー: bumper
パー: par
パーク: park (public, amusement, etc.)
パージ: purge (esp. of public officials)
パース: perspective
パーセント: percent
パーツ: part
パーティー: party (social gathering)
パーティ: party (social gathering)
パート: part
パートタイマー: part-timer
パートタイム: part time (esp. female part time employees)
パートナー: (dance) partner
パーフェクト: perfect
パープレー: scoring even-par for the entire round
パーマ: perm (hairstyle)
パール: purl (knitting stitch)
パーレン: parentheses
パイ: pie
パイナップル: pineapple (Ananas comosus)
パイプ: pipe
パイロット: pilot
パキスタン: Pakistan
パゴダ: pagoda
パシフィック: Pacific
パジャマ: pajamas
パス: passing (a test, examination, etc.)
パスタ: pasta
パスポート: passport
パスワード: password
パズル: puzzle
パソコン: personal computer
パターン: pattern
パチンコ: pachinko
パッケージ: package
パッション: passion
パッシング: headlight flashing (as a signal to another driver)
パット: putt
パテ: putty
パトカー: patrol car
パトロール: patrol
パトロン: sugar daddy
パナマ: Panama
パニック: panic
パネラー: panellist (panelist)
パネル: panel
パパ: dad
パフォーマンス: performance (e.g. music, dance, drama)
パブ: pub
パラソル: parasol (esp. one that is secured to the ground)
パラダイス: paradise
パラダイム: paradigm
パラボラ: parabola (antenna, microphone reflector, etc.)
パラボラアンテナ: parabolic antenna
パリ: Paris (France)
パルチザン: partisan
パレード: parade
パレスチナ: Palestine
パレット: palette
パロディー: parody
パワー: power
パワーアップ: powering up
パン: bread
パンク: puncture
パンジー: pansy (Viola tricolor var. hortensis)
パンダ: panda
パンチ: punch (with the fist)
パンチパーマ: curly men's hairstyle, usu. associated with yakuza or delinquents
パンツ: underpants
パンティー: panties
パントマイム: mime
パンフレット: brochure
パンプス: pumps
ヒーター: heater
ヒータ: heater
ヒール: heel (in pro wrestling)
ヒーロー: hero
ヒヤリング: listening (esp. in foreign language education)
ヒステリー: hysteria
ヒット: hit
ヒマラヤ: Himalayas
ヒューズ: fuse
ヒレ: fillet
ヒロイン: heroine
ヒンズー: Hindu
ヒント: hint
ビーチ: beach
ビート: beet
ビートルズ: Beatles
ビーナス: Venus (Roman goddess)
ヴィーナス: Venus (Roman goddess)
ビーバー: beaver
ビバ: beaver
ビーフ: beef
ビアガーデン: beer garden
ビエンナーレ: biennale (biennial art exhibition)
ビオラ: viola
ビキニ: bikini (swimwear)
ビクトリア: Victoria (Seychelles)
ビザ: visa
ビジネス: business
ビジネスマン: businessman
ビジョン: vision
ビス: screw
ビスケット: cookie
ビスタカー: vista car
ビタミン: vitamin
ビッグ: big
ビデオ: video
ビデオテープ: video tape
ビニール: vinyl
ビバーク: bivouac
ビフィズス: Lactobacillus bifidus
ビュッフェ: buffet
ビラ: holiday house
ビリヤード: billiards
ビル: multi-floor building
ビロード: velvet
ピーク: peak
ピース: peace sign
ピーチ: peach
ピーナッツ: peanut
ピーナツ: peanut
ピーピングトム: Peeping Tom
ピーマン: bell pepper
ピアス: earrings (for pierced ears)
ピアニスト: pianist
ピアノ: piano
ピエロ: clown
ピカソ: Picasso
デイ: day (as in holiday)
バチカン: ∅
ピクニック: picnic
ピケ: pique
ピザ: pizza
ピッツァ: pizza
ピストル: pistol
ピストン: piston
ピッキング: lock picking
ピック: pick
ピッチ: PHS portable phone
ピッチャー: pitcher
ピッチング: pitching
ピラニア: piranha
ピラミッド: pyramid
ピリ: period (interval of a game)
ピリオド: period (esp. in European languages)
ピル: birth-control pill
ピン: pin (e.g. hairpin, safety pin)
ピンク: pink
ピンセット: tweezers
ピンチ: pinch
ピンチヒッター: pinch hitter
ピント: focus (of a lens)
ピンポン: ping-pong
フーガ: fugue
ファースト: first
ファイア: fire
ファイト: fight
ファイル: file (for holding papers)
ファインダー: viewfinder
ファウル: foul
ファクシミリ: fax
ファシスト: fascist
ファシズム: fascism
ファストフード: fast food
ファスナー: fastener
ファッショ: fascism
ファッション: fashion
ファミリー: family
ファルス: farce (e.g. theatrical)
ファン: fan
フィート: feet
フィーリング: feeling
フィールド: field
フィアンセ: fiance
フィギュア: figure skating
フィクション: fiction
フィッティング: fitting
フィル: philharmonic
フィルハーモニー: philharmonic
フィルム: film
フイルム: film
フィンランド: Finland
フェア: fair
フェアプレー: fair play
フェスティバル: festival (esp. music, film, etc.)
フェニックス: phoenix (bird of Egyptian mythology)
フェミニスト: feminist
フェリー: ferry
フェンス: fence
フォーク: fork
ホーク: fork
フォークソング: folk song
フォード: Ford (car)
フォーマット: formatting (a disk)
フォーマル: formal
フォアグラ: foie gras
フォアハンド: forehand
フォアボール: base on balls
フォロー: follow-up
フォワード: forward
フック: hook
フットボール: football (incl. soccer, rugby, American football, etc.; esp. used for soccer)
フットワーク: footwork
フライ: deep-fried food
フライト: flight
フライドチキン: fried chicken (esp. American-style)
フライパン: fry pan
フライング: false start
フラスコ: (laboratory) flask
フラストレーション: frustration
フラッシュ: flash (esp. of a camera)
フラメンコ: flamenco
フラン: franc (currency)
フランク: frankfurter
フランクフルト: Frankfurt (Germany)
フリー: freelance
フリーエージェント: free agent
フリーズ: freezing
フリーター: (young) person subsisting on part-time work
フリーダイヤル: toll-free number
フリーマーケット: flea market
フリーランサー: freelancer
フル: full
フルーツ: fruit
フルート: flute
フレーズ: phrase
フレーム: frame
フレックス: flexible-hours system
フレッシュ: (liquid) non-dairy creamer
フレンチ: French food
フレンドリ: friendly
フローリング: wooden flooring
フロア: dance floor
フロスト: frost
フロッピー: floppy (disk)
フロッピーディスク: floppy disk
フロン: fluorocarbon
フロント: front (aspect, weather, war-front, etc.)
ブーケ: bouquet
ブーツ: boots
ブーム: boom
ブーメラン: boomerang
ブール: boule (round loaf of white bread)
ブイ: buoy
ブザー: buzzer
ブラインド: window blind
ブラウス: blouse
ブラジャー: bra
ブラスバンド: brass band
ブラック: black (coffee)
ブラボー: bravo
ブランク: gap
ブランデー: brandy
ブランド: brand
ブリッジ: bridge
ブリュッセル: Brussels (Belgium)
ブル: bull
ブルー: blue
ブルーカラー: blue-collar (worker)
ブルース: blues
ブルガリア: Bulgaria
ブルジョア: bourgeois
ブルセラ: used women's clothing such as bloomers and high-school sailor-suit uniforms (esp. as a source of sexual arousal)
ブルゾン: blouson
ブルドーザー: bulldozer
ブルネット: brunette
ブレーカー: (circuit) breaker
ブレーカ: (circuit) breaker
ブレーキ: brake
ブレーン: brains (of an operation)
ブレイク: break (rest)
ブレーク: break (rest)
ブレザー: blazer
ブレスト: breaststroke
ブレスレット: bracelet
プレゼンテーション: presentation
ブレッド: bread
ブレンド: blend
ブロー: blow
ブローカー: broker
ブローチ: brooch
ブロード: broadcloth
ブロック: blocking (e.g. the way)
ブロンズ: bronze
ブンド: bond
プール: (swimming) pool
プチ: small
プッシュホン: push-button telephone
プライド: pride
プライバシー: privacy
プライベート: private
プラザ: plaza
プラス: plus
プラスチック: plastic
プラチナ: platinum (Pt)
プラットホーム: platform
プラモデル: plastic model
プラン: plan
プランクトン: plankton
プランタン: springtime
プランナー: game designer
プリズム: prism
プリン: pudding (esp. custard)
プリンタ: printer
プリント: print
プレイ: play
プレー: play
プレート: (tectonic) plate
プレーヤー: player
プレーン: plain
プレイボーイ: playboy
プレス: pressing
プレゼント: present
プレタポルテ: ready-made clothing
プレッシャー: pressure
プレハブ: prefab
プロ: professional
プログラム: program (of events, music, etc.)
プロジェクト: project
プロセス: process
プロダクション: production
プロダクト: product
プロデュース: production
プロフィール: profile
プロフェッショナル: professional
プロポーズ: (marriage) proposal
プロレス: pro wrestling
プロレタリア: proletarian
ヘアスタイル: hairstyle
ヘクタール: hectare
ヘッドホン: headphone
ヘッドライト: headlight (on a vehicle)
ヘディング: headbutt (in boxing)
ヘビー: heavy
ヘビースモーカー: heavy smoker
ヘリ: helicopter
ヘリコプター: helicopter
ヘル: Mr
ヘルス: type of brothel/massage parlor (parlour)
ヘルツ: heart
ヘルニア: hernia
ヘルメット: helmet
ヘロイン: heroin
ベーコン: bacon
ベージュ: beige
ベース: base
ベースアップ: raise of the basic wage rate
ベースキャンプ: base camp
ベートーヴェン: Beethoven
ベール: veil
ベア: increase in basic salary
ベクター: vector
ベクトル: vector
ベスト: best
ベストセラー: bestseller
ベストテン: top ten
ベッド: bed
ベテラン: veteran (in a particular field)
ベビー: baby
ベビーカー: stroller
ベビーシッター: baby-sitter
ベランダ: balcony
ベル: bell
ベルト: belt (waist, seat, etc.)
ベルマーク: Bellmark
ベルモット: vermouth
ベレー: beret
ベンジン: gasoline
ベンチ: bench
ベンチャー: venture
頁: page
ペース: pace
ペーパー: paper
ペアリング: couple's ring
ペスト: plague
ペダル: pedal
ペッサリー: pessary
ペット: pet
ペニシリン: penicillin
ペルー: Peru
ペレストロイカ: perestroika (USSR reform movement)
ペン: pen
ペンキ: paint
ペンション: pension (Western-style boardinghouse)
ペンダント: pendant (jewelry)
ホース: hose
ホーム: (railway) platform
ホームイン: getting home
ホームシック: homesickness
ホームステイ: homestay
ホームドラマ: family-centered sitcom
ホームヘルパー: caregiver
ホームラン: home run
ホームルーム: homeroom
ホール: hall (dance, concert, etc.)
ホイール: wheel (esp. of vehicle)
ホイッスル: whistle
ホステス: hostess
ホスト: host (of a party, summit, etc.)
ホック: snap fastener
ホッケー: (field) hockey
ホップ: hop
ホテル: hotel
ホノルル: Honolulu
ホモ: homo
ホラー: horror
ホルモン: hormone
ホルン: horn (musical instrument)
ホワイト: white
ホワイトカラー: white-collar (worker)
ボー: bow (weapon)
ボーイ: bellboy
ボーイスカウト: Boy Scouts
ボーイフレンド: boyfriend
ボーイング: bowing (of a string instrument)
ボート: boat
ボード: board
ボーナス: bonus
ボーリング: bowling (esp. tenpin)
ボール: ball (pitch that falls outside of the strike zone)
ボールペン: ball-point pen
ボイコット: boycott
ボイスレコーダー: dictaphone
ボイラー: boiler
ボクサー: boxer
ボクシング: boxing
ボサノバ: bossa nova
ボス: boss
ボストン: Boston
ボスニア: Bosnia
ボタン: button (clothing)
ボックス: box
ボディー: body
ボディ: body
ボディコン: body-conscious (look)
ボトル: bottle
ボランティア: volunteer
ボリューム: volume (sound level)
ボレー: volley
ボレロ: bolero (dance)
ボン: good
ボンネット: bonnet
ボンベ: compressed gas cylinder
ポーカー: poker
ポーズ: pose
ポース: pose
ポーター: porter
ポーチ: porch
ポート: port
ポール: pole
ポイント: point (of a story, argument, etc.)
ポケット: pocket
ポケットベル: pager
ポジション: position
ポジティブ: positive (e.g. thinking)
ポスター: poster
ポスト: postbox
ポタージュ: potage (thick soup)
ポット: pot (esp. teapot, coffee-pot)
ポップ: pop
ポップス: pop music
ポテト: potato
ポテトチップス: potato chips
ポトフ: pot-au-feu
ポニーテール: ponytail
ポピュラー: popular
ポプリ: potpourri
ポリープ: polyp
ポリシー: policy
ポリス: polis (ancient Greek city state)
ポルノ: pornography
ポロ: polo
ポンド: pound (unit of weight)
ポンプ: pump
マーカー: marker
マーカ: marker
マーガリン: margarine
マーキュリー: Mercury (Roman god)
マーク: mark
マークシート: computer-scored answer sheet
マーケット: market
マーケティング: marketing
マーチ: march
マーティーニ: martini
マイ: my
マイアミ: Miami
マイカー: one's own car
マイク: mike
マイクロ: micro-
マイクロバス: minibus
マイコン: microcomputer
マイナー: minor
マイナス: minus
マイノリティー: minority
マイペース: doing things at one's own pace (e.g. slower than others)
マイホーム: one's (own) house
マイム: mime
マイル: mile
マイルド: mild
マウス: mouse (esp. laboratory)
マウンテン: mountain
マウント: mounting (e.g. a drive)
マエストロ: maestro
マガジン: magazine
マキシ: ankle-length (clothes)
マクラメ: macramé
マクロ: macro
マグニチュード: magnitude
マグネシウム: magnesium (Mg)
マザコン: being a mama's boy
マシン: machine
マシーン: machine
マジシャン: magician
マジック: magic
マス: mass
マスク: (face) mask
マスゲーム: massed calisthenics
マスコット: mascot
マスコミ: mass communication
マスター: to master (a skill)
マスタード: mustard
マスト: mast (of ship)
マスメディア: mass media
マゾ: masochist
マダム: madam
マッキントッシュ: McIntosh (apple)
マック: McDonald's (fast food restaurant)
マックス: maximum
マッチ: match (for lighting a fire)
マット: mat
マッハ: Mach (number)
マドレーヌ: madeleine (cake)
マドンナ: madonna
マナー: manners
マニア: enthusiast
マニアック: maniac (as in rabid sport fan)
マニキュア: manicure
マニュアル: (instruction) manual
マネー: money
マネジメント: management
マネージメント: management
マネジャー: manager (e.g. of a business, an idol, etc.)
マハラージャ: maharaja
マフィア: mafia
マフラー: (thick) scarf
ママ: mom
マヤ: Maya (ancient Indian tribe in Central America)
マヨネーズ: mayonnaise
マラカス: maracas
マラソン: marathon
マラリア: malaria
マリーナ: marina
マリーン: marine
マリン: marine
マリファナ: marijuana
マリンスノー: marine snow
マルク: mark (currency)
マルターゼ: maltase
マルチ: multi-post
マレーシア: Malaysia
マロン: chestnut
マンガン: manganese (Mn)
マンゴー: mango (Mangifera indica)
マンション: condominium (usu. mid or high-rise)
マンツーマン: man-to-man
マント: mantle
マンネリ: becoming stereotyped
マンパワー: manpower
マンモス: mammoth (esp. the woolly mammoth, Mammuthus primigenius)
ミーティング: meeting
ミール: meal (food, ground grain)
ミイラ: mummy
ミクロ: micro
ミクロン: micron
ミサ: (Catholic) Mass
ミサイル: missile
ミシガン: Michigan
ミシン: sewing machine
ミス: mistake
ミスター: mister
ミステリー: mystery
ミステリ: mystery
ミズーリ: Missouri
ミッション: mission
ミット: mitt
ミッドナイト: midnight
ミディ: midi (i.e. midiskirt)
ミドルホール: par-four hole
ミニ: miniskirt
ミニコミ: communications within a small range
ミニスカート: miniskirt
ミニディスク: minidisc
ミニマム: minimum
ミネラル: mineral
ミュージカル: musical
ミュージシャン: musician
ミュージック: music
ミラクル: miracle
ミリ: milli-
ミリオン: million seller
ミリグラム: milligram
ミリリットル: millilitre
ミルク: milk
ミンク: mink
ミンチ: minced meat
ムース: mousse
ムーディー: having a good atmosphere
ムード: mood
ムール: mussels
ムスタング: mustang
ムラート: mulatto
メーカー: manufacturer (esp. a major company)
メーカ: manufacturer (esp. a major company)
メイク: make-up
メーク: make-up
メーター: meter
メータ: meter
メーデー: Mayday (call for help)
メートル: metre (unit of length)
メード: maid
メール: email
メーン: main
メーンストリート: main street
メーンバンク: (company's) main financing bank
メカ: mechanism
メカニズム: mechanism
メカニック: mechanical
メジャー: major
メス: scalpel
メゾソプラノ: mezzo-soprano
メゾ・ソプラノ: mezzo-soprano
メゾン: house
メタセコイア: metasequoia
メタノール: methanol
メタン: methane
メダル: medal
メチール: methyl-
メッセ: trade fair
メッセージ: message
メディア: media
メトリック: metric
メトロ: metro
メトロノーム: metronome
メドレー: medley
メドレーリレー: medley relay (swimming)
メニュー: menu
メモ: note
メモリー: memory
メリット: advantage
メルクマール: characteristic
メルシー: thank you
メルヘン: fairy tale
メレンゲ: meringue
メロディー: melody
メロン: melon (esp. a muskmelon, Cucumis melo)
メンス: menses
メンタル: mental
メンバー: member
メンフィス: Memphis
モーゼル: Mauser
モーター: motor
モーターショー: motor show
モーツァルト: Mozart
モード: mode
モーニング: morning coat
モール: (shopping) mall
モアレ: moire (fabric)
モザイク: pixelated obscuring in images and video, usu. for censorship
モスクワ: Moscow (Russia)
モダン: modern
モチーフ: motif
モティーフ: motif
モデム: modem
モデル: model
モデルガン: replica firearm
モニター: monitor (device, software or person)
モノクロ: monochrome
モノラル: monaural
モノローグ: monologue
モラトリアム: postponement (of social responsibility)
モラル: morals
モルヒネ: morphine
モルモット: guinea pig (Cavia porcellus)
モロッコ: Morocco
モンキー: monkey
モンゴリズム: mongolism
モンスター: monster
モンタージュ: montage
モンパリ: my Paris
ヤード: yard (unit of distance)
ヤンキー: delinquent (youth)
ヤンマ: lamenting
ユー: you
ユーカラ: yukar (Ainu oral saga)
ユーカリ: eucalyptus
ユーゴ: Yugoslavia
ユーゴスラビア: Yugoslavia
ユーザー: user
ユートピア: utopia
ユーモア: humor
ユーモラス: humorous
ユーレカ: eureka
ユーロ: euro (the currency)
ユダヤ: Judea (southern Palestine)
ユナイテッド: united
ユニーク: unique
ユニット: unit
ユニバーシアード: Universiade
ユニフォーム: uniform
ユニホーム: uniform
ユリア: urea
ヨガ: yoga
ヨーガ: yoga
ヨーグルト: yogurt
ヨーロッパ: Europe
ヨット: yacht (esp. a sailing boat with one mast)
ヨルダン: Jordan
ラーゲ: sex position
ライオン: lion (Panthera leo)
ライス: rice (esp. when served on a plate)
ライセンス: license
ライター: lighter
ライト: light
ライナー: liner
ライバル: rival
ライフル: rifle
ライフワーク: lifework
ライブ: live (broadcasting, music, etc.)
ライブハウス: shop, bar, etc. where live jazz, pop, rock, etc. is performed
ライブラリー: library
ライン: line
ラウンジ: lounge
ラウンド: round (esp. in sports, negotiations, etc.)
ラガー: rugger
ラグビー: rugby
ラケット: racket
ラジウム: radium (Ra)
ラジオ: radio
ラジカセ: radio-cassette player
ラスト: last
ラダー: rudder
ラッキー: lucky
ラッキーゾーン: area between the regular outfield wall and a lower home-run fence set up at a shorter distance from home plate
ラック: rack
ラッシュ: rush hour
ラッシュアワー: rush hour
ラッセル: (Russell) snowplow
ラップ: plastic wrap
ラテン: Latin (language)
ラテンアメリカ: Latin America
ラビオリ: ravioli
ラフ: rough sketch
ラブコメ: romantic comedy
ラブソング: love song
ラブレター: love letter
ラベル: label (i.e. sticker)
レーベル: label (i.e. sticker)
ラボ: lab
ラマ: llama (Lama glama)
ラム: lamb
ラメ: lamé (cloth made from gold or silver thread)
ラリー: rally
ラワン: lauan (tree, wood)
ランキング: toplist (e.g. of WWW sites)
ランク: rank
ラング: language
ランジェリー: lingerie
ランダム: random sampling
ランチ: lunch
ランドセル: firm-sided backpack made of leather, etc. (used by Japanese elementary schoolchildren, often red for girls and black for boys)
ランドリー: laundry
ランナー: runner
ランニング: running
ランプ: lamp
リーク: leakage (of electricity)
リーグ: league
リーダー: leader
リーダーシップ: leadership
リーディング: reading
リート: lied (German song, usually for solo voice and piano)
リード: lead
リーマン: salary man
リアクション: reaction
リアル: real
リキッド: liquid
リキュール: liqueur
リクエスト: request
リクルート: recruit
レコーダー: recorder (musical instrument)
リコーダー: recorder (musical instrument)
リサイクル: recycling
リサイタル: recital
リザーブ: reserve
リス: fracture
リスク: risk
リスト: list
リスボン: Lisbon (Portugal)
リズミカル: rhythmical
リズム: rhythm
リセ: lycée
リセッション: recession
リゾート: resort
リゾット: risotto
リッターカー: car with 1000cc engine
リッチ: rich
リットル: litre
リトル: little
リニアモーターカー: linear motor train
リノール: linoleic
リハーサル: rehearsal
リハビリ: rehabilitation
リビング: living room
リピータ: person who does the same (negative) act repeatedly
リフォーム: renovation (e.g. a house)
リフレッシュ: refresh (e.g. memory, one's spirits, etc.)
リベート: rebate
リボン: ribbon
リムジン: limousine (stretched car)
リモコン: remote control
リュージュ: luge
リュックサック: rucksack
リラ: lilac (Syringa vulgaris)
リラックス: relaxing
リリース: release (of a film, product, etc.)
リリーフ: relief (e.g. bas relief)
レリーフ: relief (e.g. bas relief)
リレー: relay
リンク: link (on a website)
リング: ring
リンス: (hair) conditioner
リンチ: beating (inflicted as punishment)
リンパ: lymph
ルー: roux (mixture of butter and flour used to make sauces)
ルージュ: rouge (esp. lip rouge)
ルート: route
ルール: rule
ルーレット: roulette
ルクス: lux (unit of illuminance)
ルサンチマン: resentment
ルックス: looks
ルネサンス: Renaissance
ルネッサンス: Renaissance
ルビー: ruby
ルビ: ruby
ルポ: reportage
ルポルタージュ: reportage
ルンゲ: lung
レーク: lake
レーサー: racer
レーザー: laser
レーシングカー: racing car
レース: race
レーダー: radar
レート: rate
レーヨン: rayon
レール: rail (track)
レア: rare
レイプ: rape
レガース: leg guards
レギュラー: regular player (on a team)
レクイエム: requiem
レクリエーション: recreation
レゲエ: reggae
レコード: record (e.g. LP)
レシート: receipt
レジ: (cash) register
レジスター: (cash) register
レジスタンス: resistance (movement)
レジャー: leisure
レス: reply (on an Internet message board, chat client, etc.)
レスキュー: rescue
レストラン: restaurant (esp. Western-style)
レスリング: wrestling
レズ: lesbian
レセプション: reception
レッカー: tow truck
レッスン: lesson
レッテル: label
レディー: lady
レディ: lady
レトリック: rhetoric
レトルト: retort
レトロ: retro
レパートリー: repertoire
レフ: reflex camera
レフェリー: referee
レフト: left
レプラ: leprosy
レベル: level
ビール: beer
サンド: sandwich
カラメル: caramel (browned sugar used as flavouring)
ロック: rock (music)
ハンデ: handicap
ビア: beer
ストール: stall
レバー: lever
オール: all
インキ: ink
リポーター: reporter
レポート: report
リポート: report
レモン: lemon
レンジ: microwave oven
レンジャー: ranger
レンズ: lens
レンタカー: rental car
レンタル: rental
レンタルビデオ: rental video
レントゲン: X-ray
ロー: low
ローション: sexual lubricant
ロース: sirloin
ロースト: roast
ローズ: rose
ロゼ: rosé (wine)
ローテーション: rotation
ロープ: rope
ローラー: roller
ローラースケート: roller skating
ローン: loan
ログ: logarithm
ロケ: location (e.g. of film shoot)
ロケット: rocket
ロケハン: location scouting
ロココ: rococo
ロゴ: logo
ロス: loss
ロッカー: locker
ロックウール: rock wool
ロックンロール: rock 'n' roll
ロッジ: lodge
ロッド: rod
ロビー: lobby
ロビイスト: lobbyist
ロビング: lobbing (a ball)
ロブ: lob (esp. in tennis)
ロボット: robot
ロマン: romance (e.g. Arthurian romances)
ロング: long
ロングセラー: longtime best seller
ロングホール: par-five hole
ロンドン: London (UK)
ワード: word
ワープロ: word processor
ワールドシリーズ: World Series (baseball)
ワイド: wide
ワイドショー: infotainment television program
ワイヤ: wire
ワイア: wire
ワイヤレス: wireless microphone
ワイルド: wild
ワイン: wine
ワウ: wow (audio)
ワクチン: vaccine
ワゴン: wagon
ワシントン: Washington, D.C. (United States)
ワックス: wax (for polishing)
ワット: watt
ワッペン: badge (sewn on clothing)
ワニス: varnish
ワンタッチ: single button press
ワンピース: dress
ワンポイントリリーフ: relief pitcher brought in to face one batter
ワンマン: conductorless bus (i.e. having only a driver)
ワンルームマンション: studio apartment